...............
...............
...............
...XXXXXXXXX...
...X.......X...
...X.......X...
...X.......X...
...X.......X...
...X.......X...
...X.......X...
...X.......X...
...X.......X...
...XXXXXXXXX...
...............
...............
...............