................
...XXXXXXXXX....
...X.......X....
...X.XXXXXXX....
...X.X..........
...X.X..........
...X.X..XXXX....
...X.X..X..X....
...X.X..X..X....
...X.XXXX..X....
...X.......X....
...XXXXXXXXX....
................