..............
..............
..XXXXXXXX....
.........X....
...XXXXXXX....
...X..........
...X..........
...X..XXXX....
...X..X..X....
...X..X..X....
...XXXX..X....
.........X....
....XXXXXX....
..............
..............