...............
...............
..XXX..........
..X.X..........
..XXX..........
...............
.......XXXX....
..X.X..X..X....
..X.X..X..X....
..X.XXXX..X....
..X.......X....
..XXXXXXXXX....
...............