..................
..................
..................
....XXXXX.........
....X...X.........
....X...X.........
....XXXXXXX.......
........X.XXXXX...
....XXX.X.....X...
....X.XXX.XXX.X...
....X.....X.X.X...
....XXXXXXX.X.X...
............X.X...
...XXXXXXXXXX.X...
...X..........X...
...XXXXXXXXXXXX...
..................
..................
..................