...............
.XXXXXXXXXX....
..........X....
..XXXXXXX.X....
..X.....X.X....
..X.....XXX....
..X..XXX.......
..X..X.XX......
..X..X..XX..X..
..XXXX...XXX...
...........X...
...XXXXXXXXX...
...............